 #####
 #   ###
## # o #
# ttpt #
# o o ##
###o#t#
  #   #
  #####
