  #####
###   #
#tpo  #
### ot#
#t##o #
# # t ##
#o Ooot#
#   t  #
########
